11111111111111111111
10000000000000000001
100000B0010000000001
100B0000010000DEF001
10000000010000000001
1000000AAAAA00GHI001
1000000D000A00000001
1000000D000A000C0001
1000000D000A00000001
1000000DDDDA000K0001
100000000100000L0001
10000000010000000001
10000000010000000001
10000000000000000001
11111111111111111111