11111111111111111111
10000100000000000001
10000010000000000001
10000001000000000001
10000000100000000001
10000000011000000001
10000000000000000001
10000000000110011111
100000K0000001100001
10000000000000000001
1000000A00B0J0000001
10000000000000000001
10000000000000000001
10000000000000000001
11111111111111111111