11111111111111111111
10000000000000000001
11110000000000111001
10000000000000000001
11110000000011100001
10000000000000000001
10000100000000111001
10000100111110000001
10000100000000000001
10000000000000000001
11110000000101000001
10000000001000100001
10000000000111000001
10000000000000000001
11111111111111111111